argB	Amino Acid Biosynthesis	NON	
carA	Amino Acid Biosynthesis	NON	
ilvA	Amino Acid Biosynthesis	NON	
ilvB	Amino Acid Biosynthesis	NON	
ilvH	Amino Acid Biosynthesis	NON	
acsF	Biosynthesis of Cofactors	ycf59	
ccs1	Biosynthesis of Cofactors	ycf44; ccsB	
ccsA	Biosynthesis of Cofactors	ycf5	
chlB	Biosynthesis of Cofactors	NON	Chlorophy1 biosynthesis
chlI	Biosynthesis of Cofactors	NON	Chlorophy1 biosynthesis
chlL	Biosynthesis of Cofactors	frxC; gidB	Chlorophy1 biosynthesis
chlN	Biosynthesis of Cofactors	gidA	Chlorophy1 biosynthesis
hemA	Biosynthesis of Cofactors	NON	
hemL	Biosynthesis of Cofactors	NON	
hisH	Biosynthesis of Cofactors	NON	
hisS	Biosynthesis of Cofactors	syh	
thiG	Biosynthesis of Cofactors	NON	
thiS	Biosynthesis of Cofactors	ycf40	
clpC	Cellular Processes	NON	
clpP	Cellular Processes	NON	
dnaK	Cellular Processes	hsp70; ctp70	
ftsH	Cellular Processes	ycf25	
ftsI	Cellular Processes	NON	
ftsW	Cellular Processes	NON	
groEL	Cellular Processes	groL; cpn60	
secA	Cellular Processes	NON	
secG	Cellular Processes	ycf47	
secY	Cellular Processes	NON	
tatC	Cellular Processes	ycf43	
ycf1	Conserved Hypothetical Plastid	NON	Conserved proteins
ycf12	Conserved Hypothetical Plastid	NON	Conserved proteins
ycf15	Conserved Hypothetical Plastid	NON	Conserved proteins
ycf16	Conserved Hypothetical Plastid	sufC	Conserved proteins
ycf17	Conserved Hypothetical Plastid	NON	Conserved proteins
ycf18	Conserved Hypothetical Plastid	NON	Conserved proteins
ycf19	Conserved Hypothetical Plastid	NON	Conserved proteins
ycf2	Conserved Hypothetical Plastid	NON	Conserved proteins
ycf20	Conserved Hypothetical Plastid	NON	Conserved proteins
ycf21	Conserved Hypothetical Plastid	NON	Conserved proteins
ycf22	Conserved Hypothetical Plastid	NON	Conserved proteins
ycf23	Conserved Hypothetical Plastid	NON	Conserved proteins
ycf24	Conserved Hypothetical Plastid	NON	Conserved proteins
ycf26	Conserved Hypothetical Plastid	NON	Conserved proteins
ycf27	Conserved Hypothetical Plastid	NON	Conserved proteins
ycf29	Conserved Hypothetical Plastid	NON	Conserved proteins
ycf3	Conserved Hypothetical Plastid	NON	Conserved proteins
ycf33	Conserved Hypothetical Plastid	NON	Conserved proteins
ycf34	Conserved Hypothetical Plastid	NON	Conserved proteins
ycf35	Conserved Hypothetical Plastid	NON	Conserved proteins
ycf36	Conserved Hypothetical Plastid	NON	Conserved proteins
ycf37	Conserved Hypothetical Plastid	NON	Conserved proteins
ycf38	Conserved Hypothetical Plastid	NON	Conserved proteins
ycf39	Conserved Hypothetical Plastid	NON	Conserved proteins
ycf4	Conserved Hypothetical Plastid	NON	Conserved proteins
ycf41	Conserved Hypothetical Plastid	NON	Conserved proteins
ycf42	Conserved Hypothetical Plastid	NON	Conserved proteins
ycf45	Conserved Hypothetical Plastid	NON	Conserved proteins
ycf46	Conserved Hypothetical Plastid	NON	Conserved proteins
ycf49	Conserved Hypothetical Plastid	NON	Conserved proteins
ycf52	Conserved Hypothetical Plastid	NON	Conserved proteins
ycf53	Conserved Hypothetical Plastid	NON	Conserved proteins
ycf54	Conserved Hypothetical Plastid	NON	Conserved proteins
ycf55	Conserved Hypothetical Plastid	NON	Conserved proteins
ycf56	Conserved Hypothetical Plastid	NON	Conserved proteins
ycf58	Conserved Hypothetical Plastid	NON	Conserved proteins
ycf60	Conserved Hypothetical Plastid	NON	Conserved proteins
ycf63	Conserved Hypothetical Plastid	NON	Conserved proteins
ycf65	Conserved Hypothetical Plastid	NON	Conserved proteins
ycf66	Conserved Hypothetical Plastid	NON	Conserved proteins
ycf80	Conserved Hypothetical Plastid	NON	Conserved proteins
ycf81	Conserved Hypothetical Plastid	NON	Conserved proteins
ycf83	Conserved Hypothetical Plastid	NON	Conserved proteins
ycf84	Conserved Hypothetical Plastid	NON	Conserved proteins
ycf85	Conserved Hypothetical Plastid	NON	Conserved proteins
ycf86	Conserved Hypothetical Plastid	NON	Conserved proteins
ycf88	Conserved Hypothetical Plastid	NON	Conserved proteins
ycf89	Conserved Hypothetical Plastid	NON	Conserved proteins
ycf90	Conserved Hypothetical Plastid	NON	Conserved proteins
ycf91	Conserved Hypothetical Plastid	NON	Conserved proteins
ycf92	Conserved Hypothetical Plastid	NON	Conserved proteins
dnaB	DNA Replication and Repair	NON	
tyrC	DNA Replication and Repair	XerC	
atpA	Energy Metabolism	NON	ATP synthase
atpB	Energy Metabolism	NON	ATP synthase
atpD	Energy Metabolism	NON	ATP synthase
atpE	Energy Metabolism	NON	ATP synthase
atpF	Energy Metabolism	NON	ATP synthase
atpG	Energy Metabolism	NON	ATP synthase
atpH	Energy Metabolism	NON	ATP synthase
atpI	Energy Metabolism	NON	ATP synthase
cobA	Energy Metabolism	NON	
ftrB	Energy Metabolism	NON	
ndhA	Energy Metabolism	ndh1	NADH oxidoreductase
ndhB	Energy Metabolism	ndh2	NADH oxidoreductase
ndhC	Energy Metabolism	ndh3	NADH oxidoreductase
ndhD	Energy Metabolism	ndh4	NADH oxidoreductase
ndhE	Energy Metabolism	ndh4L	NADH oxidoreductase
ndhF	Energy Metabolism	ndh5	NADH oxidoreductase
ndhG	Energy Metabolism	ndh6	NADH oxidoreductase
ndhH	Energy Metabolism	NON	NADH oxidoreductase
ndhI	Energy Metabolism	frxB	NADH oxidoreductase
ndhJ	Energy Metabolism	NON	NADH oxidoreductase
ndhK	Energy Metabolism	psbG	NADH oxidoreductase
petA	Energy Metabolism	NON	Cytochrome b/F
petB	Energy Metabolism	NON	Cytochrome b/F
petD	Energy Metabolism	NON	Cytochrome b/F
petD2	Energy Metabolism	NON	Cytochrome b/F
petF	Energy Metabolism	NON	Cytochrome b/F
petG	Energy Metabolism	NON	Cytochrome b/F
petJ	Energy Metabolism	NON	Cytochrome b/F
petL	Energy Metabolism	ycf7	Cytochrome b/F
petM	Energy Metabolism	ycf31	Cytochrome b/F
petN	Energy Metabolism	ycf6	Cytochrome b/F
accA	Fatty Acid Metabolism	NON	
accB	Fatty Acid Metabolism	NON	
accD	Fatty Acid Metabolism	ycf11; dedB; zfpA	
acpP	Fatty Acid Metabolism	acpA; acp	
fabH	Fatty Acid Metabolism	NON	
apra1_4fosmid_00004	Hypothetical or Uncharacterized	NON	
apra1_4fosmid_00008	Hypothetical or Uncharacterized	NON	
apra1_4fosmid_00009	Hypothetical or Uncharacterized	NON	
apra1_4fosmid_00010	Hypothetical or Uncharacterized	NON	
ApraCp0008	Hypothetical or Uncharacterized	NON	
AsloCp28	Hypothetical or Uncharacterized	NON	
aspS	Hypothetical or Uncharacterized	NON	
AuanCp079	Hypothetical or Uncharacterized	NON	
bol1_fb0428_00016	Hypothetical or Uncharacterized	NON	
bot1_a8c9_00015	Hypothetical or Uncharacterized	NON	
bot1_a8c9_00019	Hypothetical or Uncharacterized	NON	
bot1_a8c9_00023	Hypothetical or Uncharacterized	NON	
bot1_a8c9_00068	Hypothetical or Uncharacterized	NON	
bot1_a8c9_00085	Hypothetical or Uncharacterized	NON	
bot1_a8c9_00104	Hypothetical or Uncharacterized	NON	
bot1_a8c9_00105	Hypothetical or Uncharacterized	NON	
bot1_a8c9_00109	Hypothetical or Uncharacterized	NON	
bot1_a8c9_00110	Hypothetical or Uncharacterized	NON	
bot1_a8c9_00112	Hypothetical or Uncharacterized	NON	
bot1_fb1691_00021	Hypothetical or Uncharacterized	NON	
CafeCp092	Hypothetical or Uncharacterized	NON	
ccmL	Hypothetical or Uncharacterized	NON	
chat1_80K_00085	Hypothetical or Uncharacterized	NON	
chat1f2_fp02q104_00026	Hypothetical or Uncharacterized	NON	
chat1f3_fb2894_1_00024	Hypothetical or Uncharacterized	NON	
chat1f3_fb2894_1_00032	Hypothetical or Uncharacterized	NON	
chat1f3_fb7784_1_00034	Hypothetical or Uncharacterized	NON	
ChatFrankenCp0031	Hypothetical or Uncharacterized	NON	
ChatFrankenCp0033	Hypothetical or Uncharacterized	NON	
ChatFrankenCp0057	Hypothetical or Uncharacterized	NON	
ChatFrankenCp0058	Hypothetical or Uncharacterized	NON	
ChatFrankenCp0066	Hypothetical or Uncharacterized	NON	
ChatFrankenCp0089	Hypothetical or Uncharacterized	NON	
ChatFrankenCp0104	Hypothetical or Uncharacterized	NON	
ChatFrankenCp0112	Hypothetical or Uncharacterized	NON	
ChatFrankenCp0120	Hypothetical or Uncharacterized	NON	
ChatFrankenCp0142	Hypothetical or Uncharacterized	NON	
ChvuCp102	Hypothetical or Uncharacterized	NON	
ChvulCp032	Hypothetical or Uncharacterized	NON	
ChvulCp036	Hypothetical or Uncharacterized	NON	
ChvulCp106	Hypothetical or Uncharacterized	NON	
crtQ	Hypothetical or Uncharacterized	NON	
ctaB	Hypothetical or Uncharacterized	NON	
CYtaCp087	Hypothetical or Uncharacterized	NON	
CYtaCp089	Hypothetical or Uncharacterized	NON	
CYtaCp090	Hypothetical or Uncharacterized	NON	
CYtaCp091	Hypothetical or Uncharacterized	NON	
CYtaCp092	Hypothetical or Uncharacterized	NON	
CYtaCp093	Hypothetical or Uncharacterized	NON	
CYtaCp094	Hypothetical or Uncharacterized	NON	
CYtaCp095	Hypothetical or Uncharacterized	NON	
CYtaCp096	Hypothetical or Uncharacterized	NON	
des1_fb3745_a3c156_00009	Hypothetical or Uncharacterized	NON	
des1_fb3745_a3c157_00001	Hypothetical or Uncharacterized	NON	
des1_fb3745_a3c158_00006	Hypothetical or Uncharacterized	NON	
des1_fb3745_a3c158_00007	Hypothetical or Uncharacterized	NON	
des1_fb3745_a3c159_00005	Hypothetical or Uncharacterized	NON	
des1_fb3745_a3c159_00009	Hypothetical or Uncharacterized	NON	
des1_fb3745_a3c159_00012	Hypothetical or Uncharacterized	NON	
des1_fb3745_a3c159_00013	Hypothetical or Uncharacterized	NON	
desA	Hypothetical or Uncharacterized	NON	
dnaJ	Hypothetical or Uncharacterized	NON	
dnaX	Hypothetical or Uncharacterized	NON	
dpoB	Hypothetical or Uncharacterized	NON	
envM	Hypothetical or Uncharacterized	NON	
Escp152	Hypothetical or Uncharacterized	NON	
Escp36	Hypothetical or Uncharacterized	NON	
ffh	Hypothetical or Uncharacterized	NON	
glgC	Hypothetical or Uncharacterized	NON	
glmS	Hypothetical or Uncharacterized	NON	
gltB	Hypothetical or Uncharacterized	glsF	
groS	Hypothetical or Uncharacterized	groES; cpn10	
gyrA	Hypothetical or Uncharacterized	NON	
Heak293_Cp006	Hypothetical or Uncharacterized	NON	
Heak293_Cp021	Hypothetical or Uncharacterized	NON	
Heak293_Cp026	Hypothetical or Uncharacterized	NON	
Heak293_Cp041	Hypothetical or Uncharacterized	NON	
Heak293_Cp099	Hypothetical or Uncharacterized	NON	
hup	Hypothetical or Uncharacterized	hcfC; hlp; hlpA	
I-CvuI	Hypothetical or Uncharacterized	NON	
infA	Hypothetical or Uncharacterized	NON	Translation factors
infB	Hypothetical or Uncharacterized	NON	Translation factors
infC	Hypothetical or Uncharacterized	NON	Translation factors
JC032	Hypothetical or Uncharacterized	NON	
leuC	Hypothetical or Uncharacterized	NON	
leuD	Hypothetical or Uncharacterized	NON	
leuS	Hypothetical or Uncharacterized	NON	
lipB	Hypothetical or Uncharacterized	NON	
lpxA	Hypothetical or Uncharacterized	NON	
lpxC	Hypothetical or Uncharacterized	NON	
map	Hypothetical or Uncharacterized	NON	
MapoCp020	Hypothetical or Uncharacterized	NON	
mat1	Hypothetical or Uncharacterized	ycf13	
matK	Hypothetical or Uncharacterized	ycf14	
menA	Hypothetical or Uncharacterized	NON	
menB	Hypothetical or Uncharacterized	NON	
menC	Hypothetical or Uncharacterized	NON	
menD	Hypothetical or Uncharacterized	NON	
menE	Hypothetical or Uncharacterized	NON	
menF	Hypothetical or Uncharacterized	NON	
minD	Hypothetical or Uncharacterized	NON	
minE	Hypothetical or Uncharacterized	NON	
moeB	Hypothetical or Uncharacterized	NON	
mraY	Hypothetical or Uncharacterized	NON	
murD	Hypothetical or Uncharacterized	NON	
NeolCp126	Hypothetical or Uncharacterized	NON	
NeolCp127	Hypothetical or Uncharacterized	NON	
NeolCp133	Hypothetical or Uncharacterized	NON	
NeolCp134	Hypothetical or Uncharacterized	NON	
NeolCp135	Hypothetical or Uncharacterized	NON	
NeolCp136	Hypothetical or Uncharacterized	NON	
NeolCp137	Hypothetical or Uncharacterized	NON	
NeolCp138	Hypothetical or Uncharacterized	NON	
NeolCp139	Hypothetical or Uncharacterized	NON	
NeolCp140	Hypothetical or Uncharacterized	NON	
NeolCp141	Hypothetical or Uncharacterized	NON	
NeolCp142	Hypothetical or Uncharacterized	NON	
NeolCp143	Hypothetical or Uncharacterized	NON	
NeolCp144	Hypothetical or Uncharacterized	NON	
NeolCp145	Hypothetical or Uncharacterized	NON	
NeolCp146	Hypothetical or Uncharacterized	NON	
NeolCp147	Hypothetical or Uncharacterized	NON	
NeolCp148	Hypothetical or Uncharacterized	NON	
NeolCp149	Hypothetical or Uncharacterized	NON	
NeolCp150	Hypothetical or Uncharacterized	NON	
NeolCp151	Hypothetical or Uncharacterized	NON	
NeolCp152	Hypothetical or Uncharacterized	NON	
NeolCp156	Hypothetical or Uncharacterized	NON	
ner1_5fosmid_00141	Hypothetical or Uncharacterized	NON	
nifS	Hypothetical or Uncharacterized	NON	
NitaCp017	Hypothetical or Uncharacterized	NON	
NitaCp023	Hypothetical or Uncharacterized	NON	
NitaCp025	Hypothetical or Uncharacterized	NON	
NitaCp037	Hypothetical or Uncharacterized	NON	
NitaCp042	Hypothetical or Uncharacterized	NON	
NitaCp079	Hypothetical or Uncharacterized	NON	
NitoCp007	Hypothetical or Uncharacterized	NON	
NitoCp017	Hypothetical or Uncharacterized	NON	
NitoCp040	Hypothetical or Uncharacterized	NON	
NitoCp102	Hypothetical or Uncharacterized	NON	
NitoCp105	Hypothetical or Uncharacterized	NON	
NitoCp106	Hypothetical or Uncharacterized	NON	
NitoCp109	Hypothetical or Uncharacterized	NON	
orf100	Hypothetical or Uncharacterized	NON	
orf101	Hypothetical or Uncharacterized	NON	
orf102	Hypothetical or Uncharacterized	NON	
orf108	Hypothetical or Uncharacterized	NON	
orf115a	Hypothetical or Uncharacterized	NON	
orf120	Hypothetical or Uncharacterized	NON	
orf122	Hypothetical or Uncharacterized	NON	
ORF126	Hypothetical or Uncharacterized	NON	
orf156	Hypothetical or Uncharacterized	NON	
orf163	Hypothetical or Uncharacterized	NON	
orf166	Hypothetical or Uncharacterized	NON	
orf188	Hypothetical or Uncharacterized	NON	
orf222	Hypothetical or Uncharacterized	NON	
orf231	Hypothetical or Uncharacterized	NON	
orf240	Hypothetical or Uncharacterized	NON	
orf241	Hypothetical or Uncharacterized	NON	
orf250	Hypothetical or Uncharacterized	NON	
orf264	Hypothetical or Uncharacterized	NON	
orf264	Hypothetical or Uncharacterized	NON	
orf265	Hypothetical or Uncharacterized	NON	
orf294	Hypothetical or Uncharacterized	NON	
orf301	Hypothetical or Uncharacterized	NON	
orf333	Hypothetical or Uncharacterized	NON	
orf386	Hypothetical or Uncharacterized	NON	
ORF40	Hypothetical or Uncharacterized	NON	
orf42	Hypothetical or Uncharacterized	NON	
orf454	Hypothetical or Uncharacterized	NON	
orf485	Hypothetical or Uncharacterized	NON	
orf56	Hypothetical or Uncharacterized	NON	
ORF60	Hypothetical or Uncharacterized	NON	
orf69	Hypothetical or Uncharacterized	NON	
orf70	Hypothetical or Uncharacterized	NON	
orf92	Hypothetical or Uncharacterized	NON	
orf92	Hypothetical or Uncharacterized	NON	
orf99	Hypothetical or Uncharacterized	NON	
OrniCp100	Hypothetical or Uncharacterized	NON	
OrniCp102	Hypothetical or Uncharacterized	NON	
OrniCp107	Hypothetical or Uncharacterized	NON	
OrniCp108	Hypothetical or Uncharacterized	NON	
OrniCp111	Hypothetical or Uncharacterized	NON	
OrniCp112	Hypothetical or Uncharacterized	NON	
OrniCp116	Hypothetical or Uncharacterized	NON	
OrsajCp007	Hypothetical or Uncharacterized	NON	
OrsajCp011	Hypothetical or Uncharacterized	NON	
OrsajCp012	Hypothetical or Uncharacterized	NON	
OrsajCp035	Hypothetical or Uncharacterized	NON	
OrsajCp039	Hypothetical or Uncharacterized	NON	
OrsajCp096	Hypothetical or Uncharacterized	NON	
OrsajCp099	Hypothetical or Uncharacterized	NON	
OrsajCp107	Hypothetical or Uncharacterized	NON	
OrsajCp110	Hypothetical or Uncharacterized	NON	
PCC_0068	Hypothetical or Uncharacterized	NON	
PCC_0084	Hypothetical or Uncharacterized	NON	
PCC_0210	Hypothetical or Uncharacterized	NON	
PCC_0312	Hypothetical or Uncharacterized	NON	
PCC_0368	Hypothetical or Uncharacterized	NON	
PCC_0402	Hypothetical or Uncharacterized	NON	
PCC_0523	Hypothetical or Uncharacterized	NON	
PCC_0636	Hypothetical or Uncharacterized	NON	
PCC_0691	Hypothetical or Uncharacterized	NON	
PCC_0720	Hypothetical or Uncharacterized	NON	
PCC_0769	Hypothetical or Uncharacterized	NON	
PCC_0849	Hypothetical or Uncharacterized	NON	
pdhA	Hypothetical or Uncharacterized	odpA	
pdhB	Hypothetical or Uncharacterized	odpB	
pgmA	Hypothetical or Uncharacterized	NON	
PikoCp034	Hypothetical or Uncharacterized	NON	
PikoCp173	Hypothetical or Uncharacterized	NON	
PikoCp197	Hypothetical or Uncharacterized	NON	
PikoCp440	Hypothetical or Uncharacterized	NON	
PikoCp445	Hypothetical or Uncharacterized	NON	
PikoCp446	Hypothetical or Uncharacterized	NON	
PikoCp447	Hypothetical or Uncharacterized	NON	
PikoCp460	Hypothetical or Uncharacterized	NON	
PikoCp608	Hypothetical or Uncharacterized	NON	
PikoCp700	Hypothetical or Uncharacterized	NON	
PikoCp935	Hypothetical or Uncharacterized	NON	
PikoCp969	Hypothetical or Uncharacterized	NON	
PithCp004	Hypothetical or Uncharacterized	NON	
PithCp012	Hypothetical or Uncharacterized	NON	
PithCp017	Hypothetical or Uncharacterized	NON	
PithCp019	Hypothetical or Uncharacterized	NON	
PithCp024	Hypothetical or Uncharacterized	NON	
PithCp026	Hypothetical or Uncharacterized	NON	
PithCp029	Hypothetical or Uncharacterized	NON	
PithCp031	Hypothetical or Uncharacterized	NON	
PithCp032	Hypothetical or Uncharacterized	NON	
PithCp034	Hypothetical or Uncharacterized	NON	
PithCp036	Hypothetical or Uncharacterized	NON	
PithCp038	Hypothetical or Uncharacterized	NON	
PithCp040	Hypothetical or Uncharacterized	NON	
PithCp057	Hypothetical or Uncharacterized	NON	
PithCp069	Hypothetical or Uncharacterized	NON	
PithCp070	Hypothetical or Uncharacterized	NON	
PithCp071	Hypothetical or Uncharacterized	NON	
PithCp072	Hypothetical or Uncharacterized	NON	
PithCp073	Hypothetical or Uncharacterized	NON	
PithCp074	Hypothetical or Uncharacterized	NON	
PithCp081	Hypothetical or Uncharacterized	NON	
PithCp082	Hypothetical or Uncharacterized	NON	
PithCp097	Hypothetical or Uncharacterized	NON	
PithCp104	Hypothetical or Uncharacterized	NON	
PithCp120	Hypothetical or Uncharacterized	NON	
PithCp125	Hypothetical or Uncharacterized	NON	
PithCp126	Hypothetical or Uncharacterized	NON	
PithCp128	Hypothetical or Uncharacterized	NON	
PithCp129	Hypothetical or Uncharacterized	NON	
PithCp131	Hypothetical or Uncharacterized	NON	
PithCp133	Hypothetical or Uncharacterized	NON	
PithCp134	Hypothetical or Uncharacterized	NON	
PithCp137	Hypothetical or Uncharacterized	NON	
PithCp138	Hypothetical or Uncharacterized	NON	
PithCp149	Hypothetical or Uncharacterized	NON	
PithCp152	Hypothetical or Uncharacterized	NON	
PithCp156	Hypothetical or Uncharacterized	NON	
PithCp159	Hypothetical or Uncharacterized	NON	
PithCp160	Hypothetical or Uncharacterized	NON	
PithCp162	Hypothetical or Uncharacterized	NON	
PithCp171	Hypothetical or Uncharacterized	NON	
Poptr_cp018	Hypothetical or Uncharacterized	NON	
Poptr_cp034	Hypothetical or Uncharacterized	NON	
Poptr_cp088	Hypothetical or Uncharacterized	NON	
Poptr_cp089	Hypothetical or Uncharacterized	NON	
Poptr_cp090	Hypothetical or Uncharacterized	NON	
Poptr_cp092	Hypothetical or Uncharacterized	NON	
Poptr_cp095	Hypothetical or Uncharacterized	NON	
PoyeCp032	Hypothetical or Uncharacterized	NON	
PoyeCp037	Hypothetical or Uncharacterized	NON	
PoyeCp048	Hypothetical or Uncharacterized	NON	
PoyeCp049	Hypothetical or Uncharacterized	NON	
PoyeCp051	Hypothetical or Uncharacterized	NON	
PoyeCp164	Hypothetical or Uncharacterized	NON	
PoyeCp168	Hypothetical or Uncharacterized	NON	
PoyeCp178	Hypothetical or Uncharacterized	NON	
PoyeCp197	Hypothetical or Uncharacterized	NON	
PoyeCp198	Hypothetical or Uncharacterized	NON	
ppiB	Hypothetical or Uncharacterized	NON	
preA	Hypothetical or Uncharacterized	NON	
prfB	Hypothetical or Uncharacterized	NON	
PS051	Hypothetical or Uncharacterized	NON	
PS069	Hypothetical or Uncharacterized	NON	
PS070	Hypothetical or Uncharacterized	NON	
PsakCp105	Hypothetical or Uncharacterized	NON	
PsnuCp093	Hypothetical or Uncharacterized	NON	
PsnuCp094	Hypothetical or Uncharacterized	NON	
PsnuCp095	Hypothetical or Uncharacterized	NON	
PsnuCp096	Hypothetical or Uncharacterized	NON	
PsnuCp097	Hypothetical or Uncharacterized	NON	
PsnuCp099	Hypothetical or Uncharacterized	NON	
PsnuCp101	Hypothetical or Uncharacterized	NON	
rne	Hypothetical or Uncharacterized	NON	
roaA	Hypothetical or Uncharacterized	ycf82	
speA	Hypothetical or Uncharacterized	NON	
SpolCp072	Hypothetical or Uncharacterized	NON	
SpolCp077	Hypothetical or Uncharacterized	NON	
sqdB	Hypothetical or Uncharacterized	NON	
syn1_81k_00005	Hypothetical or Uncharacterized	NON	
syn1_81k_00014	Hypothetical or Uncharacterized	NON	
syn1_81k_00016	Hypothetical or Uncharacterized	NON	
syn1_81k_00036	Hypothetical or Uncharacterized	NON	
syn1_81k_00040	Hypothetical or Uncharacterized	NON	
syn1_81k_00041	Hypothetical or Uncharacterized	NON	
syn1_81k_00043	Hypothetical or Uncharacterized	NON	
syn1_81k_00044	Hypothetical or Uncharacterized	NON	
syn1_81k_00045	Hypothetical or Uncharacterized	NON	
syn1_81k_00046	Hypothetical or Uncharacterized	NON	
syn1_81k_00047	Hypothetical or Uncharacterized	NON	
syn1_81k_00051	Hypothetical or Uncharacterized	NON	
syn1_81k_00057	Hypothetical or Uncharacterized	NON	
syn1_81k_00058	Hypothetical or Uncharacterized	NON	
syn1_81k_00060	Hypothetical or Uncharacterized	NON	
syn1_81k_00063	Hypothetical or Uncharacterized	NON	
syn1_81k_00070	Hypothetical or Uncharacterized	NON	
syn1_81k_00071	Hypothetical or Uncharacterized	NON	
syn1_81k_00072	Hypothetical or Uncharacterized	NON	
syn1_81k_00075	Hypothetical or Uncharacterized	NON	
syn1_81k_00077	Hypothetical or Uncharacterized	NON	
syn1_81k_00078	Hypothetical or Uncharacterized	NON	
syn1_81k_00083	Hypothetical or Uncharacterized	NON	
syn1_81k_00087	Hypothetical or Uncharacterized	NON	
syn1_81k_00088	Hypothetical or Uncharacterized	NON	
syn1_81k_00095	Hypothetical or Uncharacterized	NON	
syn1_81k_00099	Hypothetical or Uncharacterized	NON	
syn1_81k_00100	Hypothetical or Uncharacterized	NON	
syn1_fa4287_rc_00052	Hypothetical or Uncharacterized	NON	
syn1_fa9545_a11c10_00049	Hypothetical or Uncharacterized	NON	
thdF	Hypothetical or Uncharacterized	NON	
tilS	Hypothetical or Uncharacterized	ycf62	
tri1_4fosmid_00045	Hypothetical or Uncharacterized	NON	
trnI	Hypothetical or Uncharacterized	NON	
trpA	Hypothetical or Uncharacterized	NON	
trpG	Hypothetical or Uncharacterized	NON	
trxA	Hypothetical or Uncharacterized	trx; trxM	
zam	Hypothetical or Uncharacterized	NON	
apcA	Photosynthesis	NON	
apcB	Photosynthesis	NON	
apcD	Photosynthesis	NON	
apcE	Photosynthesis	NON	
apcF	Photosynthesis	NON	
cfxQ	Photosynthesis	NON	
cpcA	Photosynthesis	pcyA	
cpcB	Photosynthesis	pcyB	
cpcG	Photosynthesis	cpcC	
cpeA	Photosynthesis	rpeA	
cpeB	Photosynthesis	rpeB	
pbsA	Photosynthesis	NON	
psaA	Photosynthesis	psaA1	Photosystem I
psaB	Photosynthesis	psaA2	Photosystem I
psaC	Photosynthesis	frxA	Photosystem I
psaD	Photosynthesis	NON	Photosystem I
psaE	Photosynthesis	NON	Photosystem I
psaF	Photosynthesis	NON	Photosystem I
psaI	Photosynthesis	NON	Photosystem I
psaJ	Photosynthesis	NON	Photosystem I
psaK	Photosynthesis	NON	Photosystem I
psaL	Photosynthesis	NON	Photosystem I
psaM	Photosynthesis	NON	Photosystem I
psb28	Photosynthesis	ycf79; psbW	Photosystem II
psbA	Photosynthesis	NON	Photosystem II
psbB	Photosynthesis	NON	Photosystem II
psbC	Photosynthesis	NON	Photosystem II
psbD	Photosynthesis	NON	Photosystem II
psbE	Photosynthesis	NON	Photosystem II
psbF	Photosynthesis	NON	Photosystem II
psbH	Photosynthesis	NON	Photosystem II
psbI	Photosynthesis	NON	Photosystem II
psbJ	Photosynthesis	NON	Photosystem II
psbK	Photosynthesis	NON	Photosystem II
psbL	Photosynthesis	NON	Photosystem II
psbM	Photosynthesis	NON	Photosystem II
psbN	Photosynthesis	NON	Photosystem II
psbT	Photosynthesis	ycf8	Photosystem II
psbV	Photosynthesis	NON	Photosystem II
psbX	Photosynthesis	NON	Photosystem II
psbY	Photosynthesis	ycf32	Photosystem II
psbZ	Photosynthesis	ycf9	Photosystem II
rbcL	Photosynthesis	rbcA	Rubisco large subunit
rbcR	Photosynthesis	trsE; ycf30	Rubisco large subunit
rbcS	Photosynthesis	NON	Rubisco large subunit
glnB	Regulatory Functions	NON	
ntcA	Regulatory Functions	NON	
rpoA	Transcription	NON	RNA polymerase
rpoB	Transcription	NON	RNA polymerase
rpoBa	Transcription	NON	RNA polymerase
rpoBb	Transcription	NON	RNA polymerase
rpoC1	Transcription	NON	RNA polymerase
rpoC2	Transcription	NON	RNA polymerase
rpoD	Transcription	NON	RNA polymerase
rpoZ	Transcription	ycf61	RNA polymerase
rpl1	Translation	NON	LSU ribosomal proteins
rpl11	Translation	NON	LSU ribosomal proteins
rpl12	Translation	NON	LSU ribosomal proteins
rpl13	Translation	NON	LSU ribosomal proteins
rpl14	Translation	NON	LSU ribosomal proteins
rpl15	Translation	NON	LSU ribosomal proteins
rpl16	Translation	NON	LSU ribosomal proteins
rpl17	Translation	NON	LSU ribosomal proteins
rpl18	Translation	NON	LSU ribosomal proteins
rpl19	Translation	NON	LSU ribosomal proteins
rpl2	Translation	NON	LSU ribosomal proteins
rpl20	Translation	NON	LSU ribosomal proteins
rpl21	Translation	NON	LSU ribosomal proteins
rpl22	Translation	NON	LSU ribosomal proteins
rpl23	Translation	NON	LSU ribosomal proteins
rpl24	Translation	NON	LSU ribosomal proteins
rpl27	Translation	NON	LSU ribosomal proteins
rpl28	Translation	NON	LSU ribosomal proteins
rpl29	Translation	NON	LSU ribosomal proteins
rpl3	Translation	NON	LSU ribosomal proteins
rpl31	Translation	NON	LSU ribosomal proteins
rpl32	Translation	NON	LSU ribosomal proteins
rpl33	Translation	NON	LSU ribosomal proteins
rpl34	Translation	NON	LSU ribosomal proteins
rpl35	Translation	NON	LSU ribosomal proteins
rpl36	Translation	secX	LSU ribosomal proteins
rpl4	Translation	NON	LSU ribosomal proteins
rpl5	Translation	NON	LSU ribosomal proteins
rpl6	Translation	NON	LSU ribosomal proteins
rpl9	Translation	NON	LSU ribosomal proteins
rps1	Translation	NON	SSU ribosomal proteins
rps10	Translation	NON	SSU ribosomal proteins
rps11	Translation	NON	SSU ribosomal proteins
rps12	Translation	NON	SSU ribosomal proteins
rps13	Translation	NON	SSU ribosomal proteins
rps14	Translation	NON	SSU ribosomal proteins
rps15	Translation	NON	SSU ribosomal proteins
rps16	Translation	NON	SSU ribosomal proteins
rps17	Translation	NON	SSU ribosomal proteins
rps18	Translation	NON	SSU ribosomal proteins
rps19	Translation	NON	SSU ribosomal proteins
rps2	Translation	NON	SSU ribosomal proteins
rps20	Translation	NON	SSU ribosomal proteins
rps2a	Translation	NON	SSU ribosomal proteins
rps2b	Translation	NON	SSU ribosomal proteins
rps3	Translation	NON	SSU ribosomal proteins
rps4	Translation	NON	SSU ribosomal proteins
rps5	Translation	NON	SSU ribosomal proteins
rps6	Translation	NON	SSU ribosomal proteins
rps7	Translation	NON	SSU ribosomal proteins
rps7b	Translation	NON	SSU ribosomal proteins
rps8	Translation	NON	SSU ribosomal proteins
rps9	Translation	NON	SSU ribosomal proteins
syfB	Translation	pheT	
tsf	Translation	NON	
tufA	Translation	NON	Translation factors
cemA	Transporters	hbp; ycf10	
cysA	Transporters	mbpX	
cysT	Transporters	mbpY	
